1111111111
1P01x00001
1001111101
1000000001
1011010001
1000x10001
1111111101
1000000001
1111011111
1000000001
1111101001
1000001001
1010111001
1x1000$101
1111111111