1111111111
1P01000001
1001111011
1100000001
1011100001
1000010001
1101110001
1000000001
1011111111
1000000001
1111101011
1000001001
1010111001
101000$101
1111111111