1111111111
1P01000001
1001111011
1100000001
1011100001
1000x10001
1011110001
1000000001
1011111111
1000000001
1111101001
1000001001
1010111001
1x1000$1x1
1111111111