1111111111
1P100000x1
1010001001
1000001001
1111111011
1x00001001
1000001001
1000001101
1000000001
1010111111
1010000001
1x10000001
1111111101
1$00000001
1111111111