1111111111
1P00000001
1011111001
10000x1001
1011110001
1010000001
1100011111
11000000x1
1111110111
1000000001
1010111111
10100000x1
1010111101
10000100$1
1111111111