1111111111
1P00000001
1011111001
1000001001
1011110001
1010000001
1010011111
1100000001
1111110111
1000000001
1011111111
1010000001
1011101101
10000001$1
1111111111