1111111111
1P00000001
1011111001
10000x1001
1011110001
1010000001
1100011111
11000000x1
1111110111
1000000001
1011111111
101x000001
1011101101
10000001$1
1111111111